......FFF
F1....2..
FF>....=.
...B.=...
...B.....
...B<FF..
..3...FFF