...HAFF..
....HFF..
FFF..FF..
FFFF.F..H
AH..A..HA
H..F.FFFF
..FF..FFF
..FFH....
..FFAH...