...H1FF..
....HFF..
FFF..FF..
FFFF.F..H
2H..=..H4
H..F.FFFF
..FF..FFF
..FFH....
..FF3H...