..F..EF...A..
.F...MBBB..F.
...FF...FH...
.E....BBBBF..
A.....A.....A
..FBBBB....E.
...H....F....
F.A...E...F..
.F...F.M.F...