DDDDDDDDDDDDDDDD
DDDDWWWWWWWWWWWD
DWWWWPPPPPPPPPWD
DWPWWWPPPPPPPPWD
DWPPWWWPPPPPPPWD
DWPPPWWWPPPPPPWD
DWPPPPWPPPPPPPWD
DWPPPPPPPPPPPPWD
DWPPPPPPPPWPPPWD
DWPPPPPPPWWWPPWD
DWPPPPPPPPWWWPWD
DWPPPPPPPPPWWWWD
DWPPPPPPPPPPWWWD
DWWWWWWWWWWWDDDD
DDDDDDDDDDDDDDDD