RPPPPPPPPPPPPP
PTPPPPPPPPPPTP
PTPPPPPPTTTTTP
PTPPPPPPPPPPTP
PTPPPPPPPPPPTP
PTTTTTPPPPPPTP
PTPPPPPPPPPPTP
PPPPPPPPPPPPPW
PPPPPPPPPPPPWW