.1FF.....
.....HF2.
...F=F...
.1FH.....
....FF2..