..F...F...A..
.F...AH....F.
...FF...FH...
.H....BBBBF..
A.....A.....A
..FBBBB....H.
...H...FF....
F.A...H...F..
.F...F.A.F...