FFFFFF.....FFFF
FFFF.......FFAF
FF...H......FFF
FA............F
.......A.......
.............A.
.........H....F
.A....FF.....FF
.......F....FFF