.............
..A.......A..
.............
...A.....A...
.............
.............
A...........A
F....HAH....F
FF...A.A...FF
FF.........FF
FF....A....FF