.......A...
.FF........
F..........
M..........
.A.E.......
.......B...
FF..FF.B...
F....FFB...
M......A...
.F.........