......T......
......TTTTTT.
..T..........
..T.....H....
....H........
.............
.TTTTA..H....
....H.....T..
..T....TTTT..
..TTT..T.....
.......T.....
.............
A............