FFFFFFFFFAFF
FAHFFFF.FFAF
FHFF.H..FFFF
FFFF.FFFFFFF
...FFF...HFF
.A.F.FF.HAFF
A.A..FFH.FFF