.........FFFF...
.M.E.B..FF...A..
..E..B........B.
.....BFF......B.
.......A.BBBBBB.
.....BF.F.....B.
FFFF.B........B.
.A...BFFF....M..
...FFFF........F