PPPPPWPPPPR
PPPPPWPPPPP
PPPWWWWWPPP
PPPWDDDWPPP
PPPWDDDWPPP
PPPWDDDWPPP
PPPWWWWWPPP
RPPPPPPPPPP
RRPPPPPPPPP