...EAFF..
....EFF..
FFF..FF..
FFFF.F..E
AE..A..EA
E..F.FFFF
..FF..FFF
..FFE....
..FFAE...