..........HHHH..
.PAPPPFPFAHHHH..
..PFPPPPPPPPFFF.
..FPPPPPPPPPPFA.
..FPPPPPPPPPFP..
..PPPPPPPPPFP...
.PFFPPAPPPFP....
.PFFPPPPPFFP....
.PPFPPPPPPFPP...
...PPPPPPPPP....
...PPPHPHPP.....
....PPPAP.......
.......P........
................