PPPPPWPPP
PPPPPWPPP
PPPWWWPPP
PPPWWPPPP
PPWWPPPPP