FFF..........FFFF
........A.......F
...F....R..F..M..
...FF...R........
.....H.RRRRRAF...
..M....RFFF......
F......RFF....M..
FF..ARRRR...FF...
.....H..R....H...
..M.....R........
F...F...A..H.F...
F....FF...FF.....