RRRPPPWPPPPRRR
RRRPPPWPPPPRRR
RRRPPPWPPPPRPP
PPRPPPWWPPPRPP
PPRPPPPWPPPRPP
PPRPPPPWPPPRRR
RRRPPPPWPPPRRR
RRRPPPPWPPPRRR