...FF..........
.A.F....BBBBBA.
F...........HB.
F..FF........B.
F.......F....B.
.............B.
...F...A.....B.
.B.............
.B...FF........
.B........F..F.
HB.......F..FFF
.A...........A.
........FF.....