PPPPPWPPPRR
PPPWWWWWPPR
PPPWDDDWPPP
PPPWDDDWPPP
PPPWDDDWPPP
PPPWWWWWPPP
RPPPPPPPPPP
RRPPPPPPPPP