FFM.BBB.E..
FA.......A.
...........
..........M
...........
.A...B..A..
...A.B...EF
..M......FF