FFF.....FF.
FF..BBB.EFF
FA.......AF
...........
...........
...........
.A...B..A..
...A.B...EF
.........FF