FFF.....FF.
FF..BBB.HFF
FA.......AF
...........
...........
...........
.A...B..A..
...A.B...HF
.........FF