.....RA.R.....
.BBBBRRRRBBBB.
.B....R.....B.
.BB...R....BB.
.B....R.....B.
.B..FFRRFF..B.
.B...HRRH...B.
BBBBBRRRRBBBBB
.B..ARRRRA..B.
.BBBBRRRRBBBB.
.B.B......B.B.
.BBBB....BBBB.
.B..........B.
.B..........B.
F............F
FA..........AF
FFF........FFF