PPPPPPPP
PPPPPPPP
PPPPPPPP
PPPPPPPP
WWWWWWPP
PPPPPWWW
PPPPPPPP
WWWWPPPP
WWWWWWWW
PPPPPPPP
PPPPPPPP
PPPPPPPP