WWWWPPPPPPWWWW
WWWWPPPPPPWWWW
WWWWWPPPPWWWWW
WWWWWWPPWWWWWW
WWWWWWPPWWWWWW
WWWWPPPPPPWWWW
WWWWPPPPPPWWWW
WWWWPPPPPPWWWW
WWWWPPPPPPWWWW
WWWWPPPPPPWWWW
WWWWWPPPPWWWWW
WWWWWWPPWWWWWW
WWWWWWWWWWWWWW
PPPWWWWWWWWPPP
PPPPWWWWWWPPPP
PPPPPWWWWPPPPP
PPPPPWWWWPPPPP