PPFFPPPPP
PPPPPHFPP
PPPFPFPPP
PPFHPPPPP
PPPPFFPPP