PPPPPPPPPPPPHHHH
PPPPPPPFFPPPHHHH
PPPFFFHHPPPPPHHH
PPPPPPHHHPPPPPPH
PPPPPPPPPPFPPPPP
HPPPPPPPFFFPPPPP
HHPPPPPPPFFFPPPP
HHFFFPPPPPPPPPPP