PPPPPPPPPPPP
PPPPPPPPPPPP
PPPPPPPPPPPP
WWWWWWPPPPPP
PPPPPWWWPPPP
PPPPPPPWWWPP
PPPPPPPPPWWW
PPPPPPPPPPPP
PPPPPPPPPPPP