..F..EF...A..
.F...ABBB..F.
...FF...FE...
.E....BBBBF..
A.....A.....A
..FBBBB....E.
...E....F....
F.A...E...F..
.F...F.A.F...