..F..HF...A..
.F...ABBB..F.
...FF...FH...
.H....BBBBF..
A.....A.....A
..FBBBB....H.
...H....F....
F.A...H...F..
.F...F.A.F...