WWWWWWWWWWPPPPWW
WPPPPPPPPPPPPPWW
WWPPPPPPPPPPPPPW
WWPPPPPPPPPPPPPW
WWPPPPPPPPPPPPWW
WWPPPPPPPPPPPWWW
WPPPPPPPPPPPWWWW
WPPPPPPPPPPPWWWW
WPPPPPPPPPPPPWWW
WWWPPPPPPPPPWWWW
WWWPPPPPPPPWWWWW
WWWWPPPPPWWWWWWW
WWWWWWWPWWWWWWWW
WWWWWWWWWWWWWWWW