................
................
.....RRRRRRRRR..
..R...FFF..RAR..
..R....AF.RRRR..
..R.....FRR..R..
..RHF...RR..FR..
..RFF..RR..FFR..
..RF..RR...FHR..
..R..RRF.....R..
..RRRR.FA....R..
..RAR..FFF......
..RRRRRRRRRR....
................
................