...A..FF..A...
.......F......
.............A
.BA.FHBF...HB.
.B....BB....B.
.B....BB....B.
.BH...FBHF.AB.
A.............
......F.......
...A..FF..A...