RRRRPPPPPPRRRR
RRRRPPPPPPRRRR
RRRRRPPPPRRRRR
RRRRRRPPRRRRRR
RRRRRRPPRRRRRR
RRRRPPPPPPRRRR
RRRRPPPPPPRRRR
RRRRPPPPPPRRRR
RRRRPPPPPPRRRR
RRRRPPPPPPRRRR
RRRRRPPPPRRRRR
RRRRRRPPRRRRRR
RRRRRRRRRRRRRR
PPPRRRRRRRRPPP
PPPPRRRRRRPPPP
PPPPPRRRRPPPPP
PPPPPRRRRPPPPP