PPPPPPPWWWPPP
PPPPPPPWPPPPP
PPPPPWWWPPPPP
PPPPPWPWWPPPP
PPPPWPPPWPPPP
PPPPWWPWWPPPP
PPPPWWWPPPPPP
PPPPWPPPPPPPP
PPWWWPPPPPPPP