FFFFFF.....FFFF
FFFF.......FF0F
FF...H......FFF
F=............F
.......2.......
.............=.
.........H....F
.1....FF.....FF
.......F....FFF