.............
..2.......3..
.............
...>.....>...
.............
.............
>...........>
F....H=H....F
FF...<.<...FF
FF.........FF
FF....1....FF