PPPPPPPPPPPPPP
PPPPPPPPPPPPPP
PPPPPPPPPPPPPP
PPPPPPPPPPPPPP
PPPPPPPPPPPPPP
PPPPPPPPPPPPPP
PPPPPPPPPPPPPP
PPPPPPPPPPPPPP
PPPPPPPPPPPPPW
WWPPPPPPPPPWWW
WWWWWWWWWWWWDD