..............
RRRRRA...M....
....RR...H.T..
.T.AHRRRRRRT.R
.T.....TTTTT..
.T.....T......
.T.....T.H.M..
.T..EM.T......
.TTTTTTTTTT...
.........TA...
..............