PPPPPPPPPPPPPPPPPPPTPPPPPPP
PPTTTTTTTPPPPPPPPPPTPPPPPPP
PPTPPPPPPPPPPPPPPPPTPPPPPPP
PPTPPPPPPPTPTPTPTTTTPPPPPPP
PPTPPPPPPPTPTPTPTPPPWWWWWWW
PPPPPPPPPPTPTPTPTPPWWWWWWWW
PPPPPPPPPPPPPPTPPPPWPPPPPPP
PPPPPPPPPPTTTTTPPPPWPPPPPPP