FF.....E..FF
F.M......A.F
..B....E...F
..B.........
..B.E.......
............
..A.........
.......FFF..
.......FFF.M