PPPPPPPPPWW
PPPPPPPPWWW
PPPPPPWWWWW
PPPPWWWWWWW
PPPPWWWWWWW
PPPPPWWWWWW
PPPPPPWWWWW
PPPPPPPPWWW
PPPPPPPPPWW
PPPPPPPPPWW