....F......A.F
...A..FF..H...
..............
......M.E.....
...FF........F
...........F..
..F..E........
.M.H......A...
F.....FF..F...