..FFFFFFFFFFFFF..
.FFFFFAFFFAFFFFF.
FFFFFFFFFFFFFFFFF
FFFFFFFFFFFFFFFFF
.................
.A...H..A..H...A.
.................
FFFFFFFFFFFFFFFFF
FFFFFFFFFFFFFFFFF
.FFFFFAFFFAFFFFF.
..FFFFFFFFFFFFF..