PPPPPWDWPPPPP
PPPPPWDWPPPPP
PPPPPWDWPPPPP
PPPPPWDWPPPPP
PPPPPWDWPPPPP
PPPPWWWWWPPPP
PPPWWPPPWWPPP
PPWWPPPPPWWPP
PPWPPPPPPPWPP
PPWPPPPPPPWPP
PPWPPPPPPPWPP