PPPPPWWWPPPPP
PPPPPWWWPPPPP
PPPPPWWWPPPPP
PPPPPWWWPPPPP
PPPPPWWWPPPPP
PPPPWWWWWPPPP
PPPWWPPPWWPPP
PPWWPPPPPWWPP
PPWPPPPPPPWPP
PPWPPPPPPPWPP
PPWPPPPPPPWPP