.............
..A.......A..
.............
...A.....A...
....BBBBB....
......B......
A.....B.....A
F....HAH....F
FF...A.A...FF
FF.........FF
FF....A....FF