FFFFFFFFFFFFFF.H........F.F
FF....................FF.F.
FF..............H........F.
........H................FF
...........................
......H....................
........H...............F..
.................H.......F.