PPPWWPPPP
PPPPWPPPP
PPPPWWWPP
PPPPWPWPP
PWWWWWWWW
WWPPPPPWW
WWPPPPPPP