WWWWWWWWWWPPPPWD
WPPPPPPPPPPPPPWW
WWPPPPPPPPPPPPPW
DWPPPPPPPPPPPPPW
DWPPPPPPPPPPPPWW
WWPPPPPPPPPPPWWD
WPPPPPPPPPPPWWDD
WPPPPPPPPPPPWWDD
WPPPPPPPPPPPPWWD
WWWPPPPPPPPPWWDD
DWWPPPPPPPPWWDDD
DDWWPPPPPWWWDDDD
DDWWWWWPWWDDDDDD
DDDDDDWWWWDDDDDD