FF.....FF.H..
F.RRRRRRRRRR.
..R...M..FAR.
..RA.......R.
.MR....F.HMR.
..R........R.
..RRRR.A..FR.
...H.......R.
.F...F..FF.R.
FHF...A....RM
F.F...RRRRRR.
FF....R......
H.....R...F.F