PPPPPWPPWPPP
PPPPPWPPWPPP
PPPPWWPPWPPP
PPPPWPPPWPPP
PPPPWPPWWPPP
PPPPWPPWWPPP
PPPPWPPWWPPP
PPPPWPPWWPPP