...A..FF..A...
.......F......
.............A
.BA.FEBF...EB.
.B....BB....B.
.B....BB....B.
.BE...FBEF.AB.
A.............
......F.......
...A..FF..A...