.....FFF
.....FFF
......FF
..B....F
..B.....
..B.....
........
........
........
......FF
.I...FFF
FF...FFF