...E........
.....A.E....
............
...E..E.....
............
............
............
............