..FFFFFFFFFFFFF..
.FFFFF=FFF=FFFFF.
FFFFFFFFFFFFFFFFF
FFFFFFFFFFFFFFFFF
.................
.1...H..0..H...2.
.................
FFFFFFFFFFFFFFFFF
FFFFFFFFFFFFFFFFF
.FFFFF=FFF=FFFFF.
..FFFFFFFFFFFFF..