.........F..FFFF.
.....F..A...FFFRR
F...FFRRRRRRRRRRF
....E.RE.....FFFF
.RRRRRRF...FFFFFF
RR.....F....FFFFF
......A......FFFF
F........F.......
F...........F....