.........F..FFFF.
FF...F..A...FFFRR
FF..FFRRRRRRRRRRF
F...E.RE.....FFFF
.RRRRRRF...FFFFFF
RR.....F....FFFFF
FF....A......FFFF
FF.......F.......
F...........F....