FFFFFFFFF=FF
F2HFFFF.FF=F
FHFF.H..FFFF
FFFF.FFFFFFF
...FFF...HFF
.1.F.FF.H2FF
=.1..FFH.FFF