PTTPPPPPWPPP
PTTPPPPPWPPP
PTTPPPPPWPPP
PTTPPPPWWPPP
WWWWWWWWPPPP
WWWWWWWPPPPP
PPPPPPPPPPPP
PPPPPPPPPPPP