.FFE........
.FF..A.E....
.FF.........
.FFE..E.....
............
............
............
............