........FHF...
....F....F....
.............F
F.......F.BBBA
ABBB.F........
..............
....F....F....
...FHF........