...FF..........
.A.F....BBBBBA.
F...........EB.
F..FF........B.
F.......F....B.
.............B.
...F...A.....B.
.B.............
.B...FF........
.B........F..F.
EB.......F..FFF
.A...........A.
........FF.....