.......A...
.FF........
F..........
A..........
FA.H.......
.......B...
FF..FF.B...
F....FFB...
A......A...
FF.........