.......A...
.FF........
F..........
A..........
FA.H.......
...........
FF..FF.....
F....FF....
A......A...
FF.........