FFFFFF.....FFFF
FFFF.......FFAF
FF...E......FFF
FA............F
.......A.......
.............A.
.........E....F
.A....FF.....FF
.......F....FFF